1111111111111111111111111
1000000000000WW00000000C1
10C000T000000WW0C00000001
10000000000000W0000000001
11111111100000000000W1101
100E0000000000C000011P0C1
1111111111111111111111111