11111111111111111111111111111111111111
1001WWWWW10000000000000001C1C1C1CWWWW1
1111W0000W000000000000000000000000WWW1
100010W0WWW000000000000000000000000WW1
101010W00WWW00000000000000000000000001
1010001000WWW010000000C0000000000000C1
1011111110W000100000000000000000000011
100000001000WW10000000C000000T000000C1
11111110WWWWWW110000000000000000000011
1C00001000000000100000C0000000000000C1
100WW001110111001000000000000000000011
10WWW00000000010100000C00000110WWW00C1
1000001011111010100000000000WWWWWW1101
10111110001C0000100000000000W000000W01
10000010000WWWWWWWW00000000WW0WWWW0W01
1111101110WWWWWWWW000000000WW00WEW0W01
1000100000WWWWWWWW0000000001WW0WP00W01
101011101WWWWWWWW00000000001WW0WWWW101
1C1000001WWWWWWWW00000000000000WC00001
11111111111111111111111111111111111111