11111111
1P0CWTE1
1WW00001
11111111