1111111111111111111111111
10000000000000000000000C1
10C0000000000000C00000001
1000000000000000000000001
1111111110000000000001101
100E0000000000C000011P0C1
1111111111111111111111111